11111111111111111
10000000000000001
10001000000010001
10011100100111001
10001000010010001
10000000P00000001
11111111111111111