
	NO  xpmfile/NO.xpm
	WE	xpmfile/WE.xpm
	EA  xpmfile/EA.xpm
	SO  xpmfile/SO.xpm

F  56,56,56
C  113,113,254

1111111111111111111
    100000100000001
    100001111111111111111 111
    10000011000010000000010001
    1000001000010000000000001
    10000011000010000000010001
    11101111111011111111110001
    110000110000001      10001
    100000010000001     10001
    100000010000001      10001
    10000000000000111111111011111111111
    10000001000000100000000E00000000001
    100000010000001000000000000000000011111
    110000110000001001110000000000110010001
    111111111111111111111111111111111111111
